VVVVVVVVV
VVVVVVVVV
FVFVFVFVF
VFVFVFVFV
VVVVVVVVV
VVVVVVVVV
VVVVVVVVV
VVVVVVVVV
VVVVVVVVV
