VVFVFFVFVV
VFVFPPFVFV
FVFVFFVFVV
VFVFVVFVFV
FPFVPPVFPV
FPFVPPVFPV
VFVFVVFVFV
FVFVFFVFVV
VFVFPPFVFV
