VVVPPPPVVV
VVFFPPFFVV
PFFFFFFFFP
FFFFFFFFFF
FFFFFFFFFF
PFFFFFFFFP
VVFFFFFFVV
VVVFFFFVVV
VVVPFFPVVV
VVVPPPPVVV
