VVVVVVVVVV
VFFFFFVVFV
VVPFFVVPFF
PVVFPVVFFP
FPVVPPVVPF
FPFVVPPVVF
PFVVPPVVFP
FFPVVVVPFF
VFFFPPFFFV
VVPFFFFPVV
