VFFFFFFFFV
VFPPFFPPFV
VFPPFFPPFV
VFFFFFFFFV
VVVVPPVVVV
VVFFVVFFVV
VFPFFFFPFV
VFFPPPPFFV
VFVFFFFVFV
VFVVVVVVFV
