VVVVVVVVVV
VVPPPPPPVV
VPPFFFFPPV
VPFFFFFFPV
VVFFFFFFPV
VVFFFFFPPV
VPPPFFPPVV
VPVVPPVVVV
VPVVVVVVVV
VVVVVVVVVV
