VPVVVVVVPV
VPVPVVPVPV
VPVPFFPVPV
FVFPFFPFVF
PPPFFFFPPP
PPPFFFFPPP
FVFPFFPFVF
VPVPFFPVPV
VPVPVVPVPV
VPVVVVVVPV
